000000000000000000000000000000000000000000000000000000
000000000000000000000000000000000000000000000000000000
000000000000000000000000000000000000000000000000000000
000000000000000000000000000000000000000000000000000000
000000000000000000000000000000000000000000000000000000
000000000000000000000000000000000000000000000000000000
000000000000000000000000000000000000000000000000000000
000000000000000000000000000000000000000000000000000000
200000000000000000000000000000000000000000000000000000
220000000000000000000000000000000000000000000000000000
222000000000000000000000000000000000000000000000000000
222200000000000000000000000000000000000000002000000000
222220000000000000000000000000000000000000000000000000
222222000000000000000000000000000000000000000000000000
222222200000000000000000000000000000000000000000000000
222222220000000000000000000000000000000000000000000000
222222222000000000000000000000000000000000000000000000
111111111111111111111111111111111111111111111111111111
