000000000000000000000000000000000000000000000000000000
000000000000000000000000000000000000000000000000000000
000000000000000000000000000000000000000000000000000000
000000000000000000000000000000000000000000000000000000
000000000000000000000000000000000000000000000000000000
000000000000000000000000000000000000000000000000000000
000000000000000000000000000000000000000000000000000000
000000000000000000000000000000000000000000000000000000
000000000000000000000000000000000000000000000000000000
000000000000000000000000000000000000000000000000000000
000000000000000000000000000000000000000000000000000000
000000000000000000000000000000000000000000000000000000
000000000000000222222000000000000000000000000000000000
000000000000002000000200000000000000000000000000000000
000000000000002000000200000000000000000002222000000000
000000000002000000000000200000000000000022222000000000
000000200002000000000000200002000000000222222000000000
111111111111111111111111111111111111111111111111111111
